################################################################################
#     |*     |      *               |                                          #
#     |___   |                      |                                          #
#            |    *                 |  *    *                                  #
#  __________|__                    |      *                                   #
#  |            |                                                         *    #
#  |            |                                                              #
#               |         *         |                               *   *      #
#   * * * * * * |                   |                                          #
#  |------------|                *  |                                          #
#                 *                 |                                          #
#                                   |                                          #
#++++++++++++++++++++++++++++++++++++++++++++++++++      ++++++++++++++++++++++#
#        *       *          *          *                 |  *                  #
#                                                        |          *          #
#                                                    *   |                     #
#      *               *                  *                                  * #
#+++++++++++++++++++++++++++++++++++++++++++++++++++++++++++++++++++++++++++   #
#                           |   *                                              #
# *                 *       |                         |                        #
#                           |                         |                        #
#                           |      *                  |  *          *      *   #
#              *            |                    *    |      *                 #
#   *                       |                         |                        #
#                                       *             |    *         *         #
################################################################################
